{
  "name": "map",
  "dimensions": {
    "width": 20,
    "height": 20
  },
  "players":  2,
  "tiles": [
    "~~~~~~~~~~~~~~~~~~~~",
    "~O X~            X ~",
    "~   ~              ~",
    "~   ~              ~",
    "~  ~~   ~~~~~      ~",
    "~        ~~        ~",
    "~        ~~        ~",
    "~        ~~        ~",
    "~       X~~        ~",
    "~                  ~",
    "~                  ~",
    "~        ~~X       ~",
    "~        ~~        ~",
    "~        ~~        ~",
    "~        ~~        ~",
    "~      ~~~~~   ~~  ~",
    "~              ~   ~",
    "~              ~   ~",
    "~ X            ~X O~",
    "~~~~~~~~~~~~~~~~~~~~"
  ]
}